###################################
#                                 #
#           #              #      #
#           #             @#      #
#           #              #      #
#           #              #      #
#  ############################## #
#                                 #
#  #################  # # #########
#  #                  # #         #
###################################